{
    "jsonMap":
    [
        ["R", "R", "R", "R", "R",    "R", "R", "R", "R", "R",    "R", "R", "R", "R", "R",    "R", "R", "R", "R", "R",    "R", "R", "R", "R", "R"],
        ["R", "F", "F", "F", "F",    "F", "F", "F", "F", "F",    "F", "F", "F", "F", "F",    "F", "F", "F", "F", "F",    "F", "F", "F", "F", "R"],
        ["R", "F", "F", "F", "F",    "F", "F", "F", "F", "F",    "F", "F", "F", "F", "F",    "F", "F", "F", "F", "F",    "F", "F", "F", "F", "R"],
        ["R", "F", "F", "F", "F",    "F", "F", "F", "F", "F",    "F", "F", "F", "F", "F",    "F", "F", "F", "F", "F",    "F", "F", "F", "F", "R"],
        ["R", "F", "F", "F", "F",    "F", "F", "F", "F", "F",    "F", "F", "F", "F", "F",    "F", "F", "F", "F", "F",    "F", "F", "F", "F", "R"],
        
        ["R", "F", "F", "F", "F",    "F", "F", "F", "F", "F",    "F", "F", "F", "F", "F",    "F", "F", "F", "F", "F",    "F", "F", "F", "F", "R"],
        ["R", "F", "F", "F", "F",    "F", "F", "F", "F", "F",    "F", "F", "F", "F", "F",    "F", "F", "F", "F", "F",    "F", "F", "F", "F", "R"],
        ["R", "F", "F", "F", "F",    "T", "T", "T", "F", "F",    "F", "F", "F", "F", "F",    "F", "F", "F", "F", "F",    "F", "F", "F", "F", "R"],
        ["R", "F", "F", "F", "T",    "T", "T", "T", "T", "F",    "F", "F", "F", "F", "F",    "F", "F", "F", "F", "F",    "F", "F", "F", "F", "R"],
        ["R", "F", "F", "F", "T",    "T", "T", "F", "F", "R",    "R", "F", "F", "F", "R",    "R", "F", "F", "F", "F",    "F", "F", "F", "F", "R"],
        
        ["R", "F", "F", "F", "F",    "T", "F", "F", "F", "R",    "R", "F", "F", "F", "R",    "R", "F", "F", "F", "F",    "F", "F", "F", "F", "R"],
        ["R", "F", "F", "F", "F",    "F", "F", "F", "F", "F",    "F", "F", "F", "F", "F",    "F", "F", "F", "F", "F",    "F", "F", "F", "F", "R"],
        ["R", "F", "F", "F", "F",    "F", "F", "F", "F", "F",    "F", "F", "F", "F", "F",    "F", "F", "F", "F", "F",    "F", "F", "F", "F", "R"],
        ["R", "F", "F", "F", "F",    "F", "F", "W", "W", "W",    "F", "W", "F", "F", "F",    "F", "F", "F", "F", "F",    "F", "F", "F", "F", "R"],
        ["R", "F", "F", "F", "F",    "F", "F", "W", "W", "R",    "R", "F", "F", "F", "R",    "R", "F", "F", "F", "F",    "F", "F", "F", "F", "R"],
        
        ["R", "F", "F", "F", "F",    "F", "W", "W", "W", "R",    "R", "F", "F", "F", "R",    "R", "F", "F", "F", "F",    "F", "F", "F", "F", "R"],
        ["R", "F", "F", "F", "F",    "W", "W", "W", "W", "W",    "F", "F", "F", "F", "F",    "F", "F", "F", "F", "F",    "F", "F", "F", "F", "R"],
        ["R", "F", "F", "F", "F",    "F", "W", "W", "W", "W",    "F", "F", "F", "F", "F",    "F", "F", "F", "F", "F",    "F", "F", "F", "F", "R"],
        ["R", "F", "F", "F", "F",    "F", "W", "W", "W", "W",    "F", "F", "F", "F", "F",    "F", "F", "F", "F", "F",    "F", "F", "F", "F", "R"],
        ["R", "F", "F", "F", "F",    "R", "F", "W", "W", "F",    "F", "F", "F", "F", "F",    "F", "F", "F", "F", "F",    "F", "F", "F", "F", "R"],
        
        ["R", "F", "F", "F", "F",    "F", "F", "F", "F", "F",    "F", "F", "F", "F", "F",    "F", "F", "F", "F", "F",    "F", "F", "F", "F", "R"],
        ["R", "F", "F", "F", "F",    "F", "F", "F", "F", "F",    "F", "F", "F", "F", "F",    "F", "F", "F", "F", "F",    "F", "F", "F", "F", "R"],
        ["R", "F", "F", "F", "F",    "F", "F", "F", "F", "F",    "F", "F", "F", "F", "F",    "F", "F", "F", "F", "F",    "F", "F", "F", "F", "R"],
        ["R", "F", "F", "F", "F",    "F", "F", "F", "F", "F",    "F", "F", "F", "F", "F",    "F", "F", "F", "F", "F",    "F", "F", "F", "F", "R"],
        ["R", "R", "R", "R", "R",    "R", "R", "R", "R", "R",    "R", "R", "R", "R", "R",    "R", "R", "R", "R", "R",    "R", "R", "R", "R", "R"]
    ],
    
    "startTilePosition": {"x": 2, "y": 2},
    
    "jsonEnemies":
    [
        {
            "enemyType": "ENEMY1",
            "position": {"x": 12, "y": 17}
        },
        
        {
            "enemyType": "ENEMY5",
            "position": {"x": 17, "y": 12}
        }
    ]
}

